#########################
#@@@@@@@@@@@#@@@@@@@@@@@#
#@###@#####@#@#####@###@#
#@###@#####@@@#####@###@#
#@###@#####@#@#####@###@#
#@@@@@@@@@@@#@@@@@@@@@@@#
#@###@##@#######@##@###@#
#@@@@@##@@@@#@@@@##@@@@@#
###@#@#####@#@#####@#@###
#@@@#@@@@@@@@@@@@@@@#@@@#
#@###@#@#########@#@###@#
#@@@@@#@#########@#@@@@@#
#@###@#@#########@#@###@#
#@@@#@#@#########@#@#@@@#
###@#@#@@@@@@@@@@@#@#@###
#@@@#@#@#########@#@#@@@#
#@#@@@@@@@@@@@@@@@@@@@#@#
#@####@####@#@####@####@#
#@####@@@@@@#@@@@@@####@#
#@@@@#@###########@#@@@@#
####@#@@@@@@#@@@@@@#@####
#@@@@@@####@#@####@@@@@@#
#@####@####@#@####@####@#
#@@@@@@@@@@@@@@@@@@@@@@@#
#########################