#########################
#           #           #
# ### ##### # ##### ### #
# ### #####   ##### ### #
# ### ##### # ##### ### #
#           #           #
# ### ## ####### ## ### #
#     ##    #    ##     #
### # ##### # ##### # ###
#   #               #   #
# ### # ######### # ### #
#     # ######### #     #
# ### # ######### # ### #
#   # # ######### # #   #
### # #           # # ###
#   # # ######### # #   #
# #                   # #
# #### #### # #### #### #
# ####      #      #### #
#    # ########### #    #
#### #      #      # ####
#      #### # ####      #
# #### #### # #### #### #
#                       #
#########################